11111111111111
1000P0000C0001
10C00000E00001
11111111111111
