111111111111111
1000P00C0100E11
1000000C0000011
111111111111111